###############################
#        #           #        #
#  #  ####  ####  ####  ####  #
#  #     #     #        #     #
####  ####  ################  #
#        #     #           #  #
#  ####  #  ####  #  ####  #  #
#     #     #     #  #  #  #  #
#  ####  #  #  #######  #######
#     #  #           #        #
#  #######  #  #  #######  ####
#     #     #  #              #
#  ##########  ####  #  ####  #
#     #  #  #  #     #  #     #
####  #  #  #  #############  #
#        #     #     #        #
####  #######  #  #  #  ####  #
#     #     #     #  #     #  #
#  ####  ##########  #  #  ####
#              #     #  #     #
###############################
