###############################
#                          #  #
####  #  ####  #############  #
#     #  #  #  #     #     #  #
#  #  #  #  #  ####  ####  #  #
#  #  #     #  #  #     #     #
####  ##########  ####  #  ####
#     #                 #  #  #
####  #  #  ####  #######  #  #
#  #  #  #  #        #     #  #
#  #  #  #  #  ####  ####  #  #
#  #     #  #  #     #  #  #  #
#  ####  #  ####  #  #  #  #  #
#     #  #  #     #  #     #  #
#  ####  #  ####  #  ####  #  #
#     #  #  #     #  #     #  #
####  #  ##########  ####  #  #
#        #     #     #        #
#  ####  ####  #  #  ####  #  #
#     #  #        #        #  #
###############################
