###############################
#     #     #     #     #     #
#  ####  #######  #  #######  #
#        #  #        #     #  #
#  #######  #######  #  ####  #
#  #           #           #  #
#  #  #  ####  ####  #######  #
#     #  #              #     #
#  #  #############  #  ####  #
#  #     #     #     #        #
#######  ####  #  ####  #######
#        #           #        #
#############  #######  #  ####
#  #              #     #     #
#  #  #######  #  #######  #  #
#  #  #        #     #  #  #  #
#  ####  ####  #######  ####  #
#     #  #     #        #     #
#  #  #######  ####  ####  #  #
#  #                 #     #  #
###############################
